R 66666666 66666666
NO ./pics/xpms/greystone.xpm
SO ./pics/xpms/bluestone.xpm
WE ./pics/xpms/mossy.xpm
EA ./pics/xpms/redbrick.xpm
S ./pics/xpms/pillar.xpm


F 100,100,25
C 0,55,        70

11111
10201
10201
10201
10201
10201
10201
10201
10201
10201
10201
10201
10201
10201
10201
10201
10201
10201
10201
10201
10201
10201
10201
10201
10201
10201
10201
10201
10201
10201
10201
10201
10201
10201
10201
10201
10201
10201
10201
10201
10201
10201
10201
10201
10201
10201
10201
10201
10201
10201
10201
10201
10201
10201
10201
10201
10201
10201
10201
10201
10201
10201
10201
10201
10201
10201
10201
10201
10201
10201
10201
10201
10201
10201
10201
10201
10201
10201
10201
10201
10201
10201
10201
10201
10201
10201
10201
10201
10201
10201
10201
10201
10201
10201
10201
10201
10201
10201
10201
10201
10201
10201
10201
10201
10201
10201
10201
10201
10201
10201
10201
10201
10201
10201
10201
10201
10201
10201
10201
10201
10201
10201
10201
10201
10201
10201
10201
10201
10201
10201
10201
10201
10201
10201
10201
10201
10201
10201
10201
10201
10201
10201
10201
10201
10201
10201
10201
10201
10201
10201
10201
10201
10201
10201
10201
10201
10201
10201
10201
10201
10201
10201
10201
10201
10201
10201
10201
10201
10201
10201
10201
10201
10201
10201
10201
10201
10201
10201
10201
10201
10201
10201
10201
10201
10201
10201
10201
10201
10201
10201
10201
10201
10201
10201
10201
10201
10201
10201
10201
10201
10201
10201
10201
10201
10201
10201
10201
10201
10201
10201
10201
10201
10201
10201
10201
10201
10201
10201
10201
10201
10201
10201
10201
10201
10201
10201
10201
10201
10201
10201
10201
10201
10201
10201
10201
10201
10201
10201
10201
10201
10201
10201
10201
10201
10201
10201
10201
10201
10201
10201
10201
10201
10201
10201
10201
10201
10201
10201
10201
10201
10201
10201
10201
10201
10201
10201
10201
10201
10201
10201
10201
10201
10201
10201
10201
10201
10201
10201
10201
10201
10201
10201
10201
10201
10201
10201
10201
10201
10201
10201
10201
10201
10201
10201
10201
10201
10201
10201
10201
10201
10201
10201
10201
10201
10201
10201
10201
10201
10201
10201
10201
10201
10201
10201
10201
10201
10201
10201
10201
10201
10201
10201
10201
10201
10201
10201
10201
10201
10201
10201
10201
10201
10201
10201
10201
10201
10201
10201
10201
10201
10201
10201
10201
10201
10201
10201
10201
10201
10201
10201
10201
10201
10201
10201
10201
10201
10201
10201
10201
10201
10201
10201
10201
10201
10201
10201
10201
10201
10201
10201
10201
10201
10201
10201
10201
10201
10201
10201
10201
10201
10201
10201
10201
10201
10201
10201
10201
10201
10201
10201
10201
10201
10201
10201
10201
10201
10201
10201
10201
10201
10201
10201
10201
10201
10201
10201
10201
10201
10201
10201
10201
10201
10201
10201
10201
10201
10201
10201
10201
10201
10201
10201
10201
10201
10201
10201
10201
10201
10201
10201
10201
10201
10201
10201
10201
10201
10201
10201
10201
10201
10201
10201
10201
10201
10201
10201
10201
10201
10201
10201
10201
10201
10201
10201
10201
10201
10201
10201
10201
10201
10201
10201
10201
10201
10201
10201
10201
10201
10201
10201
10201
10201
10201
10201
10201
10201
10201
10201
10201
10201
10201
10201
10201
10201
10201
10201
10201
10201
10201
10201
10201
10201
10201
10201
10201
10201
10201
10201
10201
10201
10201
10201
10201
10201
10201
10201
10201
10201
10201
10201
10201
10201
10201
10201
10201
10201
10201
10201
10201
10201
10201
10201
10201
10201
10201
10201
10201
10201
10201
10201
10201
10201
10201
10201
10201
10201
10201
10201
10201
10201
10201
10201
10201
10201
10201
10201
10201
10201
10201
10201
10201
10201
10201
10201
10201
10201
10201
10201
10201
10201
10201
10201
10201
10201
10201
10201
10201
10201
10201
10201
10201
10201
10201
10201
10201
10201
10201
10201
10201
10201
10201
10201
10201
10201
10201
10201
10201
10201
10201
10201
10201
10201
10201
10201
10201
10201
10201
10201
10201
10201
10201
10201
10201
10201
10201
10201
10201
10201
10201
10201
10201
10201
10201
10201
10201
10201
10201
10201
10201
10201
10201
10201
10201
10201
10201
10201
10201
10201
10201
10201
10201
10201
10201
10201
10201
10201
10201
10201
10201
10201
10201
10201
10201
10201
10201
10201
10201
10201
10201
10201
10201
10201
10201
10201
10201
10201
10201
10201
10201
10201
10201
10201
10201
10201
10201
10201
10201
10201
10201
10201
10201
10201
10201
10201
10201
10201
10201
10201
10201
10201
10201
10201
10201
10201
10201
10201
10201
10201
10201
10201
10201
10201
10201
10201
10201
10201
10201
10201
10201
10201
10201
10201
10201
10201
10201
10201
10201
10201
10201
10201
10201
10201
10201
10201
10201
10201
10201
10201
10201
10201
10201
10201
10201
10201
10201
10201
10201
10201
10201
10201
10201
10201
10201
10201
10201
10201
10201
10201
10201
10201
10201
10201
10201
10201
10201
10201
10201
10201
10201
10201
10201
10201
10201
10201
10201
10201
10201
10201
10201
10201
10201
10201
10201
10201
10201
10201
10201
10201
10201
10201
10201
10201
10201
10201
10201
10201
10201
10201
10201
10201
10201
10201
10201
10201
10201
10201
10201
10201
10201
10201
10201
10201
10201
10201
10201
10201
10201
10201
10201
10201
10201
10201
10201
10201
10201
10201
10201
10201
10201
10201
10201
10201
10201
10201
10201
10201
10201
10201
10201
10201
10201
10201
10201
10201
10201
10201
10201
10201
10201
10201
10201
10201
10201
10201
10201
10201
10201
10201
10201
10201
10201
10201
10201
10201
10201
10201
10201
10201
10201
10201
10201
10201
10201
10201
10201
10201
10201
10201
10201
10201
10201
10201
10201
10201
10201
10201
10201
10201
10201
10201
10201
10201
10201
10201
10201
10201
10201
10201
10201
10201
10201
10201
10201
10201
10201
10201
10201
10201
10201
10201
10201
10201
10201
10201
10201
10201
10201
10201
10201
10201
10201
10201
10201
10201
10201
10201
10201
10201
10201
10201
10201
10201
10201
10201
10201
10201
10201
10201
10201
10201
10201
10201
10201
10201
10201
10201
10201
10201
10201
10201
10201
10201
10201
10201
10201
10201
10201
10201
10201
10201
10201
10201
10201
10201
10201
10201
10201
10201
10201
10201
10201
10201
10201
10201
10201
10201
10201
10201
10201
10201
10201
10201
10201
10201
10201
10201
10201
10201
10201
10201
10201
10201
10201
10201
10201
10201
10201
10201
10201
10201
10201
10201
10201
10201
10201
10201
10201
10201
10201
10201
10201
10201
10201
10201
10201
10201
10201
10201
10201
10201
10201
10201
10201
10201
10201
10201
10201
10201
10201
10201
10201
10201
10201
10201
10201
10201
10201
10201
10201
10201
10201
10201
10201
10201
10201
10201
10201
10201
10201
10201
10201
10201
10201
10201
10201
10201
10201
10201
10201
10201
10201
10201
10201
10201
10201
10201
10201
10201
10201
10201
10201
10201
10201
10201
10201
10201
10201
10201
10201
10201
10201
10201
10201
10201
10201
10201
10201
10201
10201
10201
10201
10201
10201
10201
10201
10201
10201
10201
10201
10201
10201
10201
10201
10201
10201
10201
10201
10201
10201
10201
10201
10201
10201
10201
10201
10201
10201
10201
10201
10201
10201
10201
10201
10201
10201
10201
10201
10201
10201
10201
10201
10201
10201
10201
10201
10201
10201
10201
10201
10201
10201
10201
10201
10201
10201
10201
10201
10201
10201
10201
10201
10201
10201
10201
10201
10201
10201
10201
10201
10201
10201
10201
10201
10201
10201
10201
10201
10201
10201
10201
10201
10201
10201
10201
10201
10201
10201
10201
10201
10201
10201
10201
10201
10201
10201
10201
10201
10201
10201
10201
10201
10201
10201
10201
10201
10201
10201
10201
10201
10201
10201
10201
10201
10201
10201
10201
10201
10201
10201
10201
10201
10201
10201
10201
10201
10201
10201
10201
10201
10201
10201
10201
10201
10201
10201
10201
10201
10201
10201
10201
10201
10201
10201
10201
10201
10201
10201
10201
10201
10201
10201
10201
10201
10201
10201
10201
10201
10201
10201
10201
10201
10201
10201
10201
10201
10201
10201
10201
10201
10201
10201
10201
10201
10201
10201
10201
10201
10201
10201
10201
10201
10201
10201
10201
10201
10201
10201
10201
10201
10201
10201
10201
10201
10201
10201
10201
10201
10201
10201
10201
10201
10201
10201
10201
10201
10201
10201
10201
10201
10201
10201
10201
10201
10201
10201
10201
10201
10201
10201
10201
10201
10201
10201
10201
10201
10201
10201
10201
10201
10201
10201
10201
10201
10201
10201
10201
10201
10201
10201
10201
10201
10201
10201
10201
10201
10201
10201
10201
10201
10201
10201
10201
10201
10201
10201
10201
10201
10201
10201
10201
10201
10201
10201
10201
10201
10201
10201
10201
10201
10201
10201
10201
10201
10201
10201
10201
10201
10201
10201
10201
10201
10201
10201
10201
10201
10201
10201
10201
10201
10201
10201
10201
10201
10201
10201
10201
10201
10201
10201
10201
10201
10201
10201
10201
10201
10201
10201
10201
10201
10201
10201
10201
10201
10201
10201
10201
10201
10201
10201
10201
10201
10201
10201
10201
10201
10201
10201
10201
10201
10201
10201
10201
10201
10201
10201
10201
10201
10201
10201
10201
10201
10201
10201
10201
10201
10201
10201
10201
10201
10201
10201
10201
10201
10201
10201
10201
10201
10201
10201
10201
10201
10201
10201
10201
10201
10201
10201
10201
10201
10201
10201
10201
10201
10201
10201
10201
10201
10201
10201
10201
10201
10201
10201
10201
10201
10201
10201
10201
10201
10201
10201
10201
10201
10201
10201
10201
10201
10201
10201
10201
10201
10201
10201
10201
10201
10201
10201
10201
10201
10201
10201
10201
10201
10201
10201
10201
10201
10201
10201
10201
10201
10201
10201
10201
10201
10201
10201
10201
10201
10201
10201
10201
10201
10201
10201
10201
10201
10201
10201
10201
10201
10201
10201
10201
10201
10201
10201
10201
10201
10201
10201
10201
10201
10201
10201
10201
10201
10201
10201
10201
10201
10201
10201
10201
10201
10201
10201
10201
10201
10201
10201
10201
10201
10201
10201
10201
10201
10201
10201
10201
10201
10201
10201
10201
10201
10201
10201
10201
10201
10201
10201
10201
10201
10201
10201
10201
10201
10201
10201
10201
10201
10201
10201
10201
10201
10201
10201
10201
10201
10201
10201
10201
10201
10201
10201
10201
10201
10201
10201
10201
10201
10201
10201
10201
10201
10201
10201
10201
10201
10201
10201
10201
10201
10201
10201
10201
10201
10201
10201
10201
10201
10201
10201
10201
10201
10201
10201
10201
10201
10201
10201
10201
10201
10201
10201
10201
10201
10201
10201
10201
10201
10201
10201
10201
10201
10201
10201
10201
10201
10201
10201
10201
10201
10201
10201
10201
10201
10201
10201
10201
10201
10201
10201
10201
10201
10201
10201
10201
10201
10201
10201
10201
10201
10201
10201
10201
10201
10201
10201
10201
10201
10201
10201
10201
10201
10201
10201
10201
10201
10201
10201
10201
10201
10201
10201
10201
10201
10201
10201
10201
10201
10201
10201
10201
10201
10201
10201
10201
10201
10201
10201
10201
10201
10201
10201
10201
10201
10201
10201
10201
10201
10201
10201
10201
10201
10201
10201
10201
10201
10201
10201
10201
10201
10201
10201
10201
10201
10201
10201
10201
10201
10201
10201
10201
10201
10201
10201
10201
10201
10201
10201
10201
10201
10201
10201
10201
10201
10201
10201
10201
10201
10201
10201
10201
10201
10201
10201
10201
10201
10201
10201
10201
10201
10201
10201
10201
10201
10201
10201
10201
10201
10201
10201
10201
10201
10201
10201
10201
10201
10201
10201
10201
10201
10201
10201
10201
10201
10201
10201
10201
10201
10201
10201
10201
10201
10201
10201
10201
10201
10201
10201
10201
10201
10201
10201
10201
10201
10201
10201
10201
10201
10201
10201
10201
10201
10201
10201
10201
10201
10201
10201
10201
10201
10201
10201
10201
10201
10201
10201
10201
10201
10201
10201
10201
10201
10201
10201
10201
10201
10201
10201
10201
10201
10201
10201
10201
10201
10201
10201
10201
10201
10201
10201
10201
10201
10201
10201
10201
10201
10201
10201
10201
10201
10201
10201
10201
10201
10201
10201
10201
10201
10201
10201
10201
10201
10201
10201
10201
10201
10201
10201
10201
10201
10201
10201
10201
10201
10201
10201
10201
10201
10201
10201
10201
10201
10201
10201
10201
10201
10201
10201
10201
10201
10201
10201
10201
10201
10201
10201
10201
10201
10201
10201
10201
10201
10201
10201
10201
10201
10201
10201
10201
10201
10201
10201
10201
10201
10201
10201
10201
10201
10201
10201
10201
10201
10201
10201
10201
10201
10201
10201
10201
10201
10201
10201
10201
10201
10201
10201
10201
10201
10201
10201
10201
10201
10201
10201
10201
10201
10201
10201
10201
10201
10201
10201
10201
10201
10201
10201
10201
10201
10201
10201
10201
10201
10201
10201
10201
10201
10201
10201
10201
10201
10201
10201
10201
10201
10201
10201
10201
10201
10201
10201
10201
10201
10201
10201
10201
10201
10201
10201
10201
10201
10201
10201
10201
10201
10201
10201
10201
10201
10201
10201
10201
10201
10201
10201
10201
10201
10201
10201
10201
10201
10201
10201
10201
10201
10201
10201
10201
10201
10201
10201
10201
10201
10201
10201
10201
10201
10201
10201
10201
10201
10201
10201
10201
10201
10201
10201
10201
10201
10201
10201
10201
10201
10201
10201
10201
10201
10201
10201
10201
10201
10201
10201
10201
10201
10201
10201
10201
10201
10201
10201
10201
10201
10201
10201
10201
10201
10201
10201
10201
10201
10201
10201
10201
10201
10201
10201
10201
10201
10201
10201
10201
10201
10201
10201
10201
10201
10201
10201
10201
10201
10201
10201
10201
10201
10201
10201
10201
10201
10201
10201
10201
10201
10201
10201
10201
10201
10201
10201
10201
10201
10201
10201
10201
10201
10201
10201
10201
10201
10201
10201
10201
10201
10201
10201
10201
10201
10201
10201
10201
10201
10201
10201
10201
10201
10201
10201
10201
10201
10201
10201
10201
10201
10201
10201
10201
10201
10201
10201
10201
10201
10201
10201
10201
10201
10201
10201
10201
10201
10201
10201
10201
10201
10201
10201
10201
10201
10201
10201
10201
10201
10201
10201
10201
10201
10201
10201
10201
10201
10201
10201
10201
10201
10201
10201
10201
10201
10201
10201
10201
10201
10201
10201
10201
10201
10201
10201
10201
10201
10201
10201
10201
10201
10201
10201
10201
10201
10201
10201
10201
10201
10201
10201
10201
10201
10201
10201
10201
10201
10201
10201
10201
10201
10201
10201
10201
10201
10201
10201
10201
10201
10201
10201
10201
10201
10201
10201
10201
10201
10201
10201
10201
10201
10201
10201
10201
10201
10201
10201
10201
10201
10201
10201
10201
10201
10201
10201
10201
10201
10201
10201
10201
10201
10201
10201
10201
10201
10201
10201
10201
10201
10201
10201
10201
10201
10201
10201
10201
10201
10201
10201
10201
10201
10201
10201
10201
10201
10201
10201
10201
10201
10201
10201
10201
10201
10201
10201
10201
10201
10201
10201
10201
10201
10201
10201
10201
10201
10201
10201
10201
10201
10201
10201
10201
1N201
11111