R 1920 1080
NO ./pics/xpms/greystone.xpm
SO ./pics/xpms/bluestone.xpm
WE ./pics/xpms/mossy.xpm
EA ./pics/xpms/redbrick.xpm
S ./pics/xpms/pillar.xpm



F 100,100,25
C 0,55,         70


111111111111111111
12222222222222221
12222222222222221
12222222222222221
12222222222222221
12222222222222221
12222222222222221
10000000000000001
1N000000000000001
1000000000000001
1000000000000001
1111111111111