

R 1000 1000
NO ./pics/xpms/greystone.xpm
SO ./pics/xpms/bluestone.xpm
WE ./pics/xpms/mossy.xpm
EA ./pics/xpms/redbrick.xpm
S ./pics/xpms/pillar.xpm


F 100,100,25
C 0,55,        70

11111

11111
100N1
1111111111111111111111111111111





