R 1920 1080
NO ./pics/xpms/bluestone.xpm
SO ./pics/xpms/greystone.xpm
WE ./pics/xpms/mossy.xpm
EA ./pics/xpms/redbrick.xpm
S ./pics/xpms/pillar.xpm



F 100.5,100,40
C 0,55,70


11111111111111111
12222222222222221
12222222222222221
12222222222222221
12222222222222221
12222222222222221
12222222222222221
10000000000000001
1N000000000000001
10000000000000001
1000000000000001
111111111111111111
