R 800 600
NO ./pics/xpms/bluestone.xpm
SO ./pics/xpms/greystone.xpm
WE ./pics/xpms/mossy.xpm
EA ./pics/xpms/redbrick.xpm
S ./pics/xpms/pillar.xpm



F 220,100,0
C 225,225,0


        1111111111111111111111111
        1000000000110000000000001
        1011000001110000002000001
        1001000000000000000000001
111111111011000001110000000000001
100000000011000001110111000111111
11110111111111011100000200001
11110111111111011101022000001
11000000110101011100000200001
10002000000000001100020000001
10000000000000001101010000001
11000001110101011111200000111
11110111 1110101 10111101S001
11111111 1111111 111111111111
