R 800 600
NO ./pics/xpms/bluestone.xpm
SO ./pics/xpms/greystone.xpm
WE ./pics/xpms/mossy.xpm
EA ./pics/xpms/redbrick.xpm
S ./pics/xpms/pillar.xpm



F 220,100,0
C 225,225,0



111111111111111111111111
100000000000000000000001
100000000000000000000001
111111111111111111111101
100000222220000303030001
100000200020000000000001
100000200020000300030001
100000200020000000000001
100000220220000303030001
100000000000000000000001
100000000000000000000001
100000000000000000000001
100000000000000000000001
100000000000000000000001
100000000000000000000001
100000000000000000000001
144444444000000000000001
140400004000000000000001
140000504000000000000001
140400004000000000000001
140444444000000000000001
140000000000000000000001
1444444440000000000000S1
111111111111111111111111

